MP_Name,earliest_sitting,latest_sitting,count_attendance,count_non_attendance,count_total_sittings_as_mp
Abdul Samad ,1/2/2021,6/7/2023,82,11,93
Alex Yam ,10/9/2012,3/8/2023,319,15,334
Alvin Tan ,24/8/2020,3/8/2023,101,9,110
Alvin Yeo ,10/9/2012,18/8/2015,73,16,89
Amrin Amin ,15/1/2016,5/6/2020,128,7,135
Amy Khor Lean Suan ,10/9/2012,3/8/2023,311,23,334
Ang Hin Kee ,10/9/2012,5/6/2020,211,13,224
Ang Wei Neng ,10/9/2012,3/8/2023,329,5,334
Anthea Ong ,1/10/2018,5/6/2020,53,0,53
Arasu Duraisamy ,1/10/2018,5/6/2020,53,0,53
Arthur Fong ,10/9/2012,18/8/2015,82,7,89
Azmoon Ahmad ,24/3/2016,10/9/2018,49,24,73
Baey Yam Keng ,10/9/2012,3/8/2023,329,5,334
Benedict Tan ,8/9/2014,18/8/2015,26,4,30
Carrie Tan ,24/8/2020,3/8/2023,100,10,110
Cedric Foo Chee Keng ,10/9/2012,5/6/2020,198,26,224
Chan Chun Sing ,10/9/2012,3/8/2023,331,3,334
Charles Chong ,10/9/2012,5/6/2020,213,11,224
Chee Hong Tat ,15/1/2016,3/8/2023,235,10,245
Chen Show Mao ,10/9/2012,5/6/2020,205,19,224
Cheng Hsing Yao ,1/2/2021,6/7/2023,77,16,93
Cheng Li Hui ,15/1/2016,6/7/2023,225,18,243
Cheryl Chan Wei Ling ,15/1/2016,3/8/2023,220,25,245
Chia Shi-Lu ,10/9/2012,5/6/2020,200,24,224
Chia Yong Yong ,8/9/2014,10/9/2018,90,13,103
Chong Kee Hiong ,15/1/2016,3/8/2023,234,11,245
Christopher de Souza ,10/9/2012,3/8/2023,328,6,334
Chua Kheng Wee Louis ,24/8/2020,3/8/2023,103,7,110
Daniel Goh Pei Siong ,29/2/2016,5/6/2020,123,6,129
Darryl David ,15/1/2016,3/8/2023,233,12,245
David Ong ,10/9/2012,1/3/2016,88,9,97
Denise Phua Lay Peng ,10/9/2012,3/8/2023,332,2,334
Dennis Tan Lip Fong ,15/1/2016,3/8/2023,244,1,245
Derrick Goh ,24/8/2020,3/8/2023,109,1,110
Desmond Choo ,15/1/2016,3/8/2023,242,3,245
Desmond Lee ,10/9/2012,3/8/2023,311,23,334
Desmond Tan ,24/8/2020,3/8/2023,104,6,110
Don Wee ,24/8/2020,3/8/2023,108,2,110
Douglas Foo ,1/10/2018,5/6/2020,42,11,53
Dr Muhammad Faishal Ibrahim ,10/9/2012,3/8/2023,325,9,334
Dr Yaacob Ibrahim ,10/9/2012,18/2/2019,167,14,181
Edward Chia Bing Hui ,24/8/2020,3/8/2023,104,6,110
Edwin Tong Chun Fai ,10/9/2012,3/8/2023,292,42,334
Ellen Lee ,10/9/2012,18/8/2015,85,4,89
Eric Chua ,24/8/2020,3/8/2023,104,6,110
Faizah Jamal ,10/9/2012,5/8/2014,59,0,59
Fatimah Lateef ,10/9/2012,5/6/2020,167,57,224
Foo Mee Har ,10/9/2012,3/8/2023,308,26,334
Gan Kim Yong ,10/9/2012,3/8/2023,322,12,334
Gan Siow Huang ,24/8/2020,3/8/2023,105,5,110
Gan Thiam Poh ,10/9/2012,3/8/2023,316,18,334
Ganesh Rajaram ,24/3/2016,10/9/2018,55,18,73
Gerald Giam Yean Song ,10/9/2012,3/8/2023,197,2,199
Goh Chok Tong ,10/9/2012,5/6/2020,207,17,224
Grace Fu Hai Yien ,10/9/2012,3/8/2023,305,29,334
Halimah Yacob ,10/9/2012,1/8/2017,136,2,138
Hany Soh ,24/8/2020,3/8/2023,103,7,110
Hawazi Daipi ,10/9/2012,18/8/2015,80,9,89
Hazel Poa ,24/8/2020,3/8/2023,98,12,110
He Ting Ru ,24/8/2020,3/8/2023,83,27,110
Heng Chee How ,10/9/2012,3/8/2023,325,9,334
Heng Swee Keat ,10/9/2012,3/8/2023,291,43,334
Hoon Hian Teck ,1/2/2021,6/7/2023,84,9,93
Hri Kumar Nair ,10/9/2012,18/8/2015,81,8,89
Inderjit Singh ,10/9/2012,18/8/2015,75,14,89
Indranee Rajah ,10/9/2012,3/8/2023,321,13,334
Intan Azura Mokhtar ,10/9/2012,5/6/2020,211,13,224
Irene Ng Phek Hoong ,10/9/2012,18/8/2015,72,17,89
Irene Quay Siew Ching ,1/10/2018,5/6/2020,43,10,53
Jamus Jerome Lim ,24/8/2020,3/8/2023,106,4,110
Janet Ang ,1/2/2021,6/7/2023,88,5,93
Janice Koh ,10/9/2012,5/8/2014,50,9,59
Janil Puthucheary ,10/9/2012,3/8/2023,326,8,334
Jessica Tan Soon Neo ,10/9/2012,3/8/2023,305,29,334
Joan Pereira ,15/1/2016,3/8/2023,235,10,245
Josephine Teo ,10/9/2012,3/8/2023,298,36,334
K Karthikeyan ,8/9/2014,18/8/2015,25,5,30
K Shanmugam ,10/9/2012,3/8/2023,280,54,334
K Thanaletchimi ,24/3/2016,10/9/2018,73,0,73
Keith Chua ,2/8/2023,3/8/2023,2,0,2
Khaw Boon Wan ,10/9/2012,5/6/2020,210,14,224
Koh Lian Pin ,1/2/2021,6/7/2023,68,25,93
Koh Poh Koon ,15/1/2016,3/8/2023,222,23,245
Kok Heng Leun ,24/3/2016,10/9/2018,63,10,73
Kuik Shiao-Yin ,8/9/2014,10/9/2018,91,12,103
Kwek Hian Chuan Henry ,15/1/2016,3/8/2023,228,17,245
Lam Pin Min ,10/9/2012,5/6/2020,208,16,224
Laurence Lien ,10/9/2012,5/8/2014,57,2,59
Lawrence Wong ,10/9/2012,3/8/2023,331,3,334
Lee Bee Wah ,10/9/2012,5/6/2020,217,7,224
Lee Hsien Loong ,10/9/2012,3/8/2023,330,4,334
Lee Kuan Yew ,10/9/2012,13/3/2015,25,57,82
Lee Li Lian ,4/2/2013,29/1/2016,74,12,86
Lee Yi Shyan ,10/9/2012,5/6/2020,202,22,224
Leon Perera ,15/1/2016,6/7/2023,236,7,243
Leong Mun Wai ,24/8/2020,3/8/2023,104,6,110
Liang Eng Hwa ,10/9/2012,3/8/2023,319,15,334
Lily Neo ,10/9/2012,5/6/2020,210,14,224
Lim Biow Chuan ,10/9/2012,3/8/2023,320,14,334
Lim Hng Kiang ,10/9/2012,5/6/2020,207,17,224
Lim Sun Sun ,1/10/2018,5/6/2020,48,5,53
Lim Swee Say ,10/9/2012,5/6/2020,185,39,224
Lim Wee Kiak ,10/9/2012,3/8/2023,321,13,334
Lina Chiam ,10/9/2012,18/8/2015,87,2,89
Louis Ng Kok Kwang ,15/1/2016,3/8/2023,245,0,245
Low Thia Khiang ,10/9/2012,5/6/2020,216,8,224
Low Yen Ling ,10/9/2012,3/8/2023,324,10,334
Lui Tuck Yew ,10/9/2012,18/8/2015,85,4,89
Mah Bow Tan ,10/9/2012,18/8/2015,70,19,89
Mahdev Mohan ,24/3/2016,10/9/2018,50,23,73
Mariam Jaafar ,24/8/2020,3/8/2023,103,7,110
Mark Chay ,1/2/2021,6/7/2023,87,6,93
Mark Lee ,2/8/2023,3/8/2023,2,0,2
Mary Liew ,10/9/2012,5/8/2014,47,12,59
Masagos Zulkifli B M M ,10/9/2012,3/8/2023,278,56,334
Melvin Yong Yik Chye ,15/1/2016,3/8/2023,244,1,245
Michael Palmer ,11/9/2012,16/11/2012,7,0,7
Mohamad Maliki Bin Osman ,10/9/2012,3/8/2023,292,42,334
Mohamed Irshad ,1/10/2018,5/6/2020,53,0,53
Mohd Fahmi Aliman ,24/8/2020,3/8/2023,99,11,110
Mohd Ismail Hussein ,8/9/2014,18/8/2015,23,7,30
Muhamad Faisal Bin Abdul Manap ,10/9/2012,3/8/2023,318,16,334
Murali Pillai ,9/5/2016,3/8/2023,220,6,226
Nadia Ahmad Samdin ,24/8/2020,3/8/2023,109,1,110
Neil Parekh Nimil Rajnikant ,2/8/2023,3/8/2023,2,0,2
Ng Chee Meng ,15/1/2016,5/6/2020,120,15,135
Ng Eng Hen ,10/9/2012,3/8/2023,289,45,334
Ng Ling Ling ,24/8/2020,3/8/2023,110,0,110
Nicholas Fang ,10/9/2012,5/8/2014,54,5,59
Ong Hua Han ,2/8/2023,3/8/2023,2,0,2
Ong Teng Koon ,10/9/2012,5/6/2020,212,12,224
Ong Ye Kung ,15/1/2016,3/8/2023,231,14,245
Patrick Tay Teck Guan ,10/9/2012,3/8/2023,319,15,334
Penny Low ,10/9/2012,18/8/2015,80,9,89
Png Eng Huat ,10/9/2012,5/6/2020,221,3,224
Poh Li San ,24/8/2020,3/8/2023,105,5,110
Pritam Singh ,10/9/2012,3/8/2023,331,3,334
R Dhinakaran ,10/9/2012,5/8/2014,58,1,59
Rachel Ong ,24/8/2020,3/8/2023,109,1,110
Raeesah Khan ,24/8/2020,3/11/2021,27,16,43
Rahayu Mahzam ,15/1/2016,3/8/2023,236,9,245
Raj Joshua Thomas ,1/2/2021,3/8/2023,87,8,95
Randolph Tan ,8/9/2014,10/9/2018,97,6,103
Raymond Lim Siang Keat ,10/9/2012,18/8/2015,64,25,89
Razwana Begum Abdul Rahim ,2/8/2023,3/8/2023,2,0,2
Rita Soh Siow Lan ,8/9/2014,18/8/2015,28,2,30
S Iswaran ,10/9/2012,3/8/2023,287,47,334
Saktiandi Supaat ,15/1/2016,3/8/2023,240,5,245
Sam Tan Chin Siong ,10/9/2012,5/6/2020,190,34,224
Seah Kian Peng ,10/9/2012,3/8/2023,306,28,334
See Jinli Jean ,2/8/2023,3/8/2023,2,0,2
Seng Han Thong ,10/9/2012,18/8/2015,84,5,89
Shahira Abdullah ,1/2/2021,6/7/2023,77,16,93
Sharael Taha ,24/8/2020,3/8/2023,110,0,110
Shawn Huang Wei Zhong ,24/8/2020,3/8/2023,106,4,110
Sim Ann ,10/9/2012,3/8/2023,309,25,334
Sitoh Yih Pin ,10/9/2012,3/8/2023,320,14,334
Sun Xueling ,15/1/2016,3/8/2023,228,17,245
Syed Harun Alhabsyi ,2/8/2023,3/8/2023,2,0,2
Sylvia Lim ,10/9/2012,3/8/2023,321,13,334
Tan Chuan-Jin ,10/9/2012,6/7/2023,299,33,332
Tan Kheng Boon Eugene ,10/9/2012,5/8/2014,52,7,59
Tan Kiat How ,24/8/2020,3/8/2023,108,2,110
Tan See Leng ,24/8/2020,3/8/2023,106,4,110
Tan Su Shan ,10/9/2012,5/8/2014,51,8,59
Tan Tai Yong ,8/9/2014,18/8/2015,23,7,30
Tan Wu Meng ,15/1/2016,3/8/2023,236,9,245
Tan Yia Swam ,1/2/2021,6/7/2023,73,20,93
Teo Chee Hean ,10/9/2012,3/8/2023,306,28,334
Teo Ho Pin ,10/9/2012,5/6/2020,199,25,224
Teo Ser Luck ,10/9/2012,5/6/2020,199,25,224
Teo Siong Seng ,10/9/2012,5/8/2014,48,11,59
Terence Ho Wee San ,1/10/2018,5/6/2020,52,1,53
Tharman Shanmugaratnam ,10/9/2012,6/7/2023,288,44,332
Thomas Chua Kee Seng ,8/9/2014,10/9/2018,94,9,103
Tin Pei Ling ,10/9/2012,3/8/2023,314,20,334
Usha Chandradas ,2/8/2023,3/8/2023,2,0,2
Vikram Nair ,10/9/2012,3/8/2023,318,16,334
Vivian Balakrishnan ,10/9/2012,3/8/2023,286,48,334
Walter Theseira ,1/10/2018,5/6/2020,52,1,53
Wan Rizal ,24/8/2020,3/8/2023,109,1,110
Wong Kan Seng ,10/9/2012,18/8/2015,82,7,89
Xie Yao Quan ,24/8/2020,3/8/2023,103,7,110
Yaacob Ibrahim ,26/2/2019,5/6/2020,43,0,43
Yee Chia Hsing ,15/1/2016,5/6/2020,134,1,135
Yee Jenn Jong ,10/9/2012,18/8/2015,83,6,89
Yeo Guat Kwang ,10/9/2012,18/8/2015,81,8,89
Yeo Wan Ling ,24/8/2020,3/8/2023,105,5,110
Yip Hon Weng ,24/8/2020,3/8/2023,108,2,110
Yip Pin Xiu ,1/10/2018,5/6/2020,34,19,53
Zainal Sapari ,10/9/2012,5/6/2020,209,15,224
Zainudin Nordin ,10/9/2012,18/8/2015,81,8,89
Zaqy Mohamad ,10/9/2012,3/8/2023,314,20,334
Zhulkarnain Abdul Rahim ,24/8/2020,3/8/2023,109,1,110
